6,8,
1,12,2,2,4,1,
1,3,2,2,7,1,
1,5,5,21,21,1,
1,8,8,10,10,1,
1,0,0,0,0,1,
1,0,0,0,0,1,
1,1,-1,-1,1,1,
